33333333333333333333
31111111111111111113
31111111111111111113
31111111111111111113
31111111111111111113
31111111111111111113
31121111111111111113
31221111111111111113
31221111111111111113
31122211111112211113
31122211111111221113
31112111111111111113
31111111111111111113
31111111111111111113
31111111111111111113
31111111112211111113
31111111112211111113
31111111121111111113
31111111111111111113
33333333333333333333