33333333
30000003
30010003
30000013
30000013
30000003
30100003
33333333