33333333
30000003
00010000
00000000
00000000
30000103
30000003
33333333