33333333
30000003
00010000
00000100
00001100
30000003
30100003
33333333