33333333
30000003
30010003
30000003
30000003
30000103
30000003
33333333