33333333333333333333
30000000000000000003
30000004000000400003
30000440000000040003
30000000000044000003
30000000000000000003
30400000000000000003
30004000000000004003
30040000000000000003
30000000000000000003
30000000000000000003
30000000000000000003
30000000000000000003
30000000000000000003
30004400000000040003
30004400000000440003
30000040000000000003
30000000000000000003
30000004000000000003
33333333333333333333